Complexity	複雑性	計算量、複雑度、集合体
Declaration	宣言
Deprecated	廃止予定
Document	ドキュメント
Erik	エリック	【人名】
Model	モデル
O'Leary	オライリー	【人名】オライリー、オレーリー、オレアリー、オリーリ  【参考】O'Leary - Wikipedia : https://en.wikipedia.org/wiki/O%27Leary
RST	RST	RST = reStructuredText (軽量マークアップ言語の一種)
backend	バックエンド
determine	判断	判定、決定
documentation	ドキュメンテーション
good idea	得策	名案、良案、良い考え
helper	補助	手助けとなる、介助、お手伝い、支援
interactive mode	インタラクティブモード	対話型実行方式
statement	ステートメント
tabulator	タブ
thread	スレッド
thread pool	スレッドプール
object	オブジェクト
custom	カスタム
Usage	用法
heap	ヒープ
Create	作成	作る、生成
new	新規	新しい
empty	空	無、虚空
Wrapper	ラッパー
JavaScript	JavaScript
wordwrap	ワードラップ
string	文字列
module	モジュール
algorithm	アルゴリズム
Encodes	エンコード
representation	形式	表現
base64	Base64
characters	文字
openarray	無蓋配列	openarray のこと。 Dephi言語ではオープン配列、ほかの言語では可変長配列を指す。「無蓋」の出典は「ニューセンチュリー英和辞典」より。
array	配列	アレイ、アレー
syntactic sugar	シンタックスシュガー	糖衣構文
macro	マクロ
system	システム
implements	実装
Syntax sugar	シンタックスシュガー
anonymous procedures	無名プロシージャ
procedure types	プロシージャ型
tree representing	ツリー構造	represent(ing)が何を指しているのか考えること。
limited	制限された
subset	サブセット
subset	部分集合
identical	同じ	同一値
checksums	チェックサム
computing	計算	演算
encoder	エンコーダー
decoder	デコーダー
value	値
naming	命名
design	仕様書
design	設計
design	設計
design	デザイン
